{
    "types" : [ 0, 0, 0, 0, 0,  0, 0, 0, 0, 0,  0, 3, 2, 2, 3,  0, 0, 0, 0, 0,
                0, 0, 0, 0, 0,  1, 0, 0, 1, 0,  0, 3, 2, 2, 3,  0, 0, 0, 0, 0,
                0, 0, 0, 0, 0,  0, 0, 0, 0, 0,  3, 3, 2, 2, 3,  1, 0, 1, 0, 0,
                0, 0, 0, 0, 0,  0, 1, 0, 0, 3,  3, 2, 2, 2, 3,  0, 1, 1, 0, 0,
                0, 0, 0, 0, 0,  0, 0, 0, 3, 3,  2, 2, 2, 2, 3,  0, 0, 0, 0, 0,

                0, 1, 0, 0, 0,  0, 0, 3, 3, 2,  2, 2, 3, 2, 2,  3, 0, 0, 0, 0,
                0, 0, 0, 0, 0,  0, 3, 3, 2, 2,  2, 3, 3, 2, 2,  3, 0, 0, 1, 0,
                0, 0, 0, 1, 0,  0, 3, 2, 2, 2,  3, 1, 3, 2, 2,  3, 0, 0, 0, 0,
                0, 0, 1, 0, 0,  0, 3, 2, 2, 3,  1, 1, 3, 2, 3,  3, 0, 1, 0, 0,
                0, 0, 0, 0, 0,  0, 3, 2, 2, 3,  3, 3, 2, 2, 3,  0, 0, 0, 0, 0,

                0, 0, 0, 0, 1,  0, 3, 2, 2, 3,  2, 2, 2, 2, 3,  0, 0, 0, 0, 0,
                0, 1, 0, 0, 0,  3, 3, 2, 2, 2,  2, 2, 3, 3, 3,  0, 0, 0, 0, 1,
                0, 0, 0, 0, 0,  3, 2, 2, 2, 2,  3, 3, 3, 1, 1,  0, 1, 0, 0, 0,
                0, 0, 1, 3, 3,  2, 2, 2, 3, 3,  3, 0, 0, 0, 0,  0, 0, 0, 0, 1,
                0, 0, 0, 3, 2,  2, 2, 3, 3, 0,  0, 0, 0, 0, 1,  0, 0, 1, 0, 0,

                0, 3, 3, 2, 2,  2, 3, 3, 0, 0,  0, 0, 0, 0, 1,  0, 0, 0, 0, 0,
                3, 3, 2, 2, 2,  3, 3, 0, 0, 0,  0, 0, 0, 0, 0,  0, 1, 0, 0, 0,
                3, 2, 2, 2, 3,  3, 0, 0, 0, 0,  0, 0, 1, 0, 0,  0, 0, 0, 0, 0,
                2, 2, 2, 3, 3,  0, 0, 0, 1, 0,  0, 0, 0, 0, 0,  0, 0, 0, 1, 0,
                2, 2, 3, 3, 0,  0, 0, 0, 0, 0,  0, 0, 0, 0, 0,  0, 0, 0, 0, 0 ],

    "resources" : [ -1, -1, -1, -1, -1,  -1, -1, -1, -1, -1,  -1, -1, -1, -1, -1,  -1, -1, -1, -1,  3,
                     0, -1,  0, -1, -1,  -1, -1, -1, -1, -1,  -1, -1, -1, -1, -1,  -1, -1, -1,  2, -1,
                    -1,  0, -1, -1, -1,  -1,  2, -1, -1, -1,  -1, -1, -1, -1, -1,  -1, -1, -1, -1, -1,
                     0, -1, -1,  0, -1,  -1,  3, -1, -1, -1,  -1, -1, -1, -1, -1,  -1, -1, -1, -1, -1,
                    -1, -1, -1, -1, -1,  -1, -1, -1, -1, -1,  -1, -1, -1, -1, -1,  -1, -1, -1,  3, -1,

                    -1, -1, -1, -1,  3,  -1, -1, -1, -1, -1,  -1, -1, -1, -1, -1,  -1, -1, -1, -1, -1,
                    -1, -1,  2, -1, -1,  -1, -1, -1, -1, -1,  -1, -1, -1, -1, -1,  -1, -1, -1, -1, -1,
                    -1, -1, -1,  3, -1,  -1, -1, -1, -1, -1,  -1, -1, -1, -1, -1,  -1, -1, -1, -1,  3,
                    -1,  3, -1, -1,  3,  -1, -1, -1, -1, -1,  -1, -1, -1, -1, -1,  -1, -1, -1, -1, -1,
                    -1, -1,  3,  2, -1,  -1, -1, -1, -1, -1,  -1, -1, -1, -1, -1,  -1, -1, -1, -1,  3,

                    -1,  3, -1, -1, -1,  -1, -1, -1, -1, -1,  -1, -1, -1, -1, -1,  -1, -1,  2, -1,  3,
                    -1, -1, -1,  3, -1,  -1, -1, -1, -1, -1,  -1, -1, -1, -1, -1,  -1, -1, -1,  3, -1,
                    -1,  2, -1,  3, -1,  -1, -1, -1, -1, -1,  -1, -1, -1, -1, -1,  -1, -1, -1,  2, -1,
                    -1,  3, -1, -1, -1,  -1, -1, -1, -1, -1,  -1, -1, -1, -1, -1,  -1, -1, -1, -1, -1,
                    -1,  2,  3, -1, -1,  -1, -1, -1, -1, -1,  -1, -1, -1, -1, -1,  -1, -1, -1, -1, -1,

                    -1, -1, -1, -1, -1,  -1, -1, -1,  2, -1,  -1, -1, -1,  2, -1,  -1, -1, -1, -1, -1,
                    -1, -1, -1, -1, -1,  -1, -1, -1, -1, -1,  -1, -1, -1, -1, -1,  -1, -1,  3, -1,  2,
                    -1, -1, -1, -1, -1,  -1,  2, -1, -1, -1,  -1,  1, -1, -1, -1,  -1, -1, -1,  3, -1,
                    -1, -1, -1, -1, -1,  -1, -1, -1, -1,  1,  -1, -1,  1, -1,  3,  -1, -1, -1, -1, -1,
                    -1, -1, -1, -1,  2,  -1, -1, -1,  1, -1,  -1,  1, -1, -1, -1,  -1, -1, -1, -1, -1 ],

    "buildings" : [ -1, -1, -1, -1, -1,  -1, -1, -1, -1, -1,  -1, -1, -1, -1, -1,  -1, -1, -1, -1, -1,
                    -1, -1, -1, -1, -1,  -1, -1, -1, -1, -1,  -1, -1, -1, -1, -1,  -1, -1, -1, -1, -1,
                    -1, -1, -1, -1, -1,  -1, -1, -1, -1, -1,  -1, -1, -1, -1, -1,  -1, -1, -1, -1, -1,
                    -1, -1, -1, -1, -1,  -1, -1, -1, -1, -1,  -1, -1, -1, -1, -1,  -1, -1, -1, -1, -1,
                    -1, -1, -1, -1, -1,  -1, -1, -1, -1, -1,  -1, -1, -1, -1, -1,  -1, -1, -1, -1, -1,

                    -1, -1, -1, -1, -1,  -1, -1, -1, -1, -1,  -1, -1, -1, -1, -1,  -1, -1, -1, -1, -1,
                    -1, -1, -1, -1, -1,  -1, -1, -1, -1, -1,  -1, -1, -1, -1, -1,  -1, -1, -1, -1, -1,
                    -1, -1, -1, -1, -1,  -1, -1, -1, -1, -1,  -1, -1, -1, -1, -1,  -1, -1, -1, -1, -1,
                    -1, -1, -1, -1, -1,  -1, -1, -1, -1, -1,  -1, -1, -1, -1, -1,  -1, -1, -1, -1, -1,
                    -1, -1, -1, -1, -1,  -1, -1, -1, -1, -1,  -1, -1, -1, -1, -1,  -1, -1, -1, -1, -1,

                    -1, -1, -1, -1, -1,  -1, -1, -1, -1, -1,  -1, -1, -1, -1, -1,  -1, -1, -1, -1, -1,
                    -1, -1, -1, -1, -1,  -1, -1, -1, -1, -1,  -1, -1, -1, -1, -1,  -1, -1, -1, -1, -1,
                    -1, -1, -1, -1, -1,  -1, -1, -1, -1, -1,  -1, -1, -1, -1, -1,  -1, -1, -1, -1, -1,
                    -1, -1, -1, -1, -1,  -1, -1, -1, -1, -1,  -1, -1, -1, -1, -1,  -1, -1, -1, -1, -1,
                    -1, -1, -1, -1, -1,  -1, -1, -1, -1, -1,  -1, -1, -1, -1, -1,  -1, -1, -1, -1, -1,

                    -1, -1, -1, -1, -1,  -1, -1, -1, -1, -1,  -1, -1, -1, -1, -1,  -1, -1, -1, -1, -1,
                    -1, -1, -1, -1, -1,  -1, -1, -1, -1, -1,  -1, -1, -1, -1, -1,  -1, -1, -1, -1, -1,
                    -1, -1, -1, -1, -1,  -1, -1, -1, -1, -1,  -1, -1, -1, -1, -1,  -1, -1, -1, -1, -1,
                    -1, -1, -1, -1, -1,  -1, -1, -1, -1, -1,  -1, -1, -1, -1, -1,  -1, -1, -1, -1, -1,
                    -1, -1, -1, -1, -1,  -1, -1, -1, -1, -1,  -1, -1, -1, -1, -1,  -1, -1, -1, -1, -1 ],

    "building_ids" : [ -1, -1, -1, -1, -1,  -1, -1, -1, -1, -1,  -1, -1, -1, -1, -1,  -1, -1, -1, -1, -1,
                       -1, -1, -1, -1, -1,  -1, -1, -1, -1, -1,  -1, -1, -1, -1, -1,  -1, -1, -1, -1, -1,
                       -1, -1, -1, -1, -1,  -1, -1, -1, -1, -1,  -1, -1, -1, -1, -1,  -1, -1, -1, -1, -1,
                       -1, -1, -1, -1, -1,  -1, -1, -1, -1, -1,  -1, -1, -1, -1, -1,  -1, -1, -1, -1, -1,
                       -1, -1, -1, -1, -1,  -1, -1, -1, -1, -1,  -1, -1, -1, -1, -1,  -1, -1, -1, -1, -1,
   
                       -1, -1, -1, -1, -1,  -1, -1, -1, -1, -1,  -1, -1, -1, -1, -1,  -1, -1, -1, -1, -1,
                       -1, -1, -1, -1, -1,  -1, -1, -1, -1, -1,  -1, -1, -1, -1, -1,  -1, -1, -1, -1, -1,
                       -1, -1, -1, -1, -1,  -1, -1, -1, -1, -1,  -1, -1, -1, -1, -1,  -1, -1, -1, -1, -1,
                       -1, -1, -1, -1, -1,  -1, -1, -1, -1, -1,  -1, -1, -1, -1, -1,  -1, -1, -1, -1, -1,
                       -1, -1, -1, -1, -1,  -1, -1, -1, -1, -1,  -1, -1, -1, -1, -1,  -1, -1, -1, -1, -1,
   
                       -1, -1, -1, -1, -1,  -1, -1, -1, -1, -1,  -1, -1, -1, -1, -1,  -1, -1, -1, -1, -1,
                       -1, -1, -1, -1, -1,  -1, -1, -1, -1, -1,  -1, -1, -1, -1, -1,  -1, -1, -1, -1, -1,
                       -1, -1, -1, -1, -1,  -1, -1, -1, -1, -1,  -1, -1, -1, -1, -1,  -1, -1, -1, -1, -1,
                       -1, -1, -1, -1, -1,  -1, -1, -1, -1, -1,  -1, -1, -1, -1, -1,  -1, -1, -1, -1, -1,
                       -1, -1, -1, -1, -1,  -1, -1, -1, -1, -1,  -1, -1, -1, -1, -1,  -1, -1, -1, -1, -1,
   
                       -1, -1, -1, -1, -1,  -1, -1, -1, -1, -1,  -1, -1, -1, -1, -1,  -1, -1, -1, -1, -1,
                       -1, -1, -1, -1, -1,  -1, -1, -1, -1, -1,  -1, -1, -1, -1, -1,  -1, -1, -1, -1, -1,
                       -1, -1, -1, -1, -1,  -1, -1, -1, -1, -1,  -1, -1, -1, -1, -1,  -1, -1, -1, -1, -1,
                       -1, -1, -1, -1, -1,  -1, -1, -1, -1, -1,  -1, -1, -1, -1, -1,  -1, -1, -1, -1, -1,
                       -1, -1, -1, -1, -1,  -1, -1, -1, -1, -1,  -1, -1, -1, -1, -1,  -1, -1, -1, -1, -1 ],

    "Gold" : 5,
    "Stone" : 5,
    "Wood" : 5,
    "Bread" : 5,
    "Fish" : 5,
    "Population" : 0
}